type octile
height 25
width 37
map
@@@@@@@@@@@@@@@@@@@@@@@@@@@@@@@@@@@@@
@e...........e@@@@@@@@@@@@@@@@@@@@@@@
@.............@@@@@@@@@@@@@@@@@@@@@@@
@e.e.e.e.e.e.e.e.e@e.e.e.e.e.e.e.e.e@
@.@.@.@.@.@.@.@.@.@.@.@.@.@.@.@.@.@.@
@e.e.e.e.e.e.e.e.e@e.e.e.e.e.e.e.e.e@
@.@.@@@@@@@@@.@.@@@@@.@.@@@@@@@@@.@.@
@e.e@@@@@@@@@e.e@@@@@e.e@@@@@@@@@e.e@
@.@.@@@@@@@@@.@.@@@@@.@.@@@@@@@@@.@.@
@e.e@@@@@@@@@e.e@@@@@e.e@@@@@@@@@e.e@
@.@.@@@@@@@@@.@.@@@@@.@.@@@@@@@@@.@.@
@e.e@@@@@@@@@e.e@@@@@e.e@@@@@@@@@e.e@
@.@.@@@@@@@@@.@.@@@@@.@.@@@@@@@@@.@.@
@e.e.e.e.e.e.e.e.e.e.e.e.e.e.e.e.e.e@
@.@.@@@@@@@@@.@.@@@@@.@.@@@@@@@@@.@.@
@e.e@@@@@@@@@e.e@@@@@e.e@@@@@@@@@e.e@
@.@.@@@@@@@@@.@.@@@@@.@.@@@@@@@@@.@.@
@e.e@@@@@@@@@e.e@@@@@e.e@@@@@@@@@e.e@
@.@.@@@@@@@@@.@.@@@@@.@.@@@@@@@@@.@.@
@e.e@@@@@@@@@e.e@@@@@e.e@@@@@@@@@e.e@
@.@.@@@@@@@@@.@.@@@@@.@.@@@@@@@@@.@.@
@e.e.e.e.e.e.e.e.e@e.e.e.e.e.e.e.e.e@
@.@.@.@.@.@.@.@.@.@.@.@.@.@.@.@.@.@.@
@e.e.e.e.e.e.e.e.e@e.e.e.e.e.e.e.e.e@
@@@@@@@@@@@@@@@@@@@@@@@@@@@@@@@@@@@@@
