type octile
height 27
width 37
map
@@@@@@@@@@@@@@@@@@@@@@@@@@@@@@@@@@@@@
@..e.e.e.e.e.e.e.e.e.e.e.e.e.e.e.e.e@
@.............@@@@@@@@@@@@@@@@@@@@@.@
@e@@@@@@@@@@@@@e.e.e.e.e.e.e.e.e.e.e@
@.@@@@@@@@@@@@@.@@@@@@@@@@@@@@@@@@@@@
@e.e.e.e.e.e.e.e.e@e.e.e.e.e.e.e.e.e@
@.@.@.@.@.@.@.@.@.@.@.@.@.@.@.@.@.@.@
@e.e.e.e.e.e.e.e.e@e.e.e.e.e.e.e.e.e@
@.@.@@@@@@@@@.@.@@@@@.@.@@@@@@@@@.@.@
@e.e@@@@@@@@@e.e@@@@@e.e@@@@@@@@@e.e@
@.@.@@@@@@@@@.@.@@@@@.@.@@@@@@@@@.@.@
@e.e@@@@@@@@@e.e@@@@@e.e@@@@@@@@@e.e@
@.@.@@@@@@@@@.@.@@@@@.@.@@@@@@@@@.@.@
@e.e@@@@@@@@@e.e@@@@@e.e@@@@@@@@@e.e@
@.@.@@@@@@@@@.@.@@@@@.@.@@@@@@@@@.@.@
@e.e.e.e.e.e.e.e.e.e.e.e.e.e.e.e.e.e@
@.@.@@@@@@@@@.@.@@@@@.@.@@@@@@@@@.@.@
@e.e@@@@@@@@@e.e.e.e.e.e@@@@@@@@@e.e@
@.@.@@@@@@@@@.@.@@@@@.@.@@@@@@@@@.@.@
@e.e@@@@@@@@@e.e@@@@@e.e@@@@@@@@@e.e@
@.@.@@@@@@@@@.@.@@@@@.@.@@@@@@@@@.@.@
@e.e@@@@@@@@@e.e@@@@@e.e@@@@@@@@@e.e@
@.@.@@@@@@@@@.@.@@@@@.@.@@@@@@@@@.@.@
@e.e.e.e.e.e.e.e.e@e.e.e.e.e.e.e.e.e@
@.@.@.@.@.@.@.@.@.@.@.@.@.@.@.@.@.@.@
@e.e.e.e.e.e.e.e.e@e.e.e.e.e.e.e.e.e@
@@@@@@@@@@@@@@@@@@@@@@@@@@@@@@@@@@@@@
