63 75 0 0 0 1 5 1
63 74 0 0 0 1 6 2
65 76 0 0 0 1 3 3
65 73 0 0 0 1 1 4
65 75 0 0 0 1 3 5
66 75 0 0 0 1 2 6
65 74 0 0 0 1 2 7
65 76 0 0 0 1 1 8
63 73 0 0 0 1 4 9
64 74 0 0 0 1 3 10
63 75 0 0 0 1 4 11
66 73 0 0 0 1 5 12
66 75 0 0 0 1 1 13
63 74 0 0 0 1 1 14
64 76 0 0 0 1 2 15
66 74 0 0 0 1 7 16
64 74 0 0 0 1 5 17
66 73 0 0 0 1 2 18
66 74 0 0 0 1 4 19
63 73 0 0 0 1 3 20
