63 76 0 0 0 1 2 1
63 75 0 0 0 1 5 2
65 75 0 0 0 1 3 3
64 73 0 0 0 1 5 4
65 75 0 0 0 1 1 5
64 74 0 0 0 1 2 6
64 74 0 0 0 1 4 7
65 73 0 0 0 1 2 8
66 76 0 0 0 1 3 9
65 76 0 0 0 1 4 10
63 76 0 0 0 1 5 11
63 73 0 0 0 1 1 12
63 73 0 0 0 1 6 13
63 75 0 0 0 1 4 14
64 75 0 0 0 1 2 15
64 74 0 0 0 1 3 16
64 76 0 0 0 1 1 17
63 73 0 0 0 1 4 18
65 74 0 0 0 1 1 19
65 73 0 0 0 1 3 20
