66 75 0 0 0 1 1 1
66 76 0 0 0 1 7 2
66 76 0 0 0 1 6 3
66 73 0 0 0 1 1 4
65 75 0 0 0 1 4 5
63 73 0 0 0 1 5 6
66 76 0 0 0 1 2 7
63 75 0 0 0 1 3 8
66 76 0 0 0 1 3 9
66 76 0 0 0 1 4 10
64 76 0 0 0 1 5 11
66 73 0 0 0 1 2 12
64 74 0 0 0 1 1 13
65 73 0 0 0 1 4 14
64 76 0 0 0 1 1 15
66 74 0 0 0 1 2 16
66 75 0 0 0 1 2 17
63 73 0 0 0 1 6 18
66 73 0 0 0 1 3 19
64 74 0 0 0 1 3 20
