65 74 0 0 0 1 1 1
65 73 0 0 0 1 6 2
63 75 0 0 0 1 2 3
63 76 0 0 0 1 5 4
63 76 0 0 0 1 1 5
63 73 0 0 0 1 2 6
65 75 0 0 0 1 3 7
65 76 0 0 0 1 3 8
64 74 0 0 0 1 2 9
64 76 0 0 0 1 6 10
63 73 0 0 0 1 1 11
66 75 0 0 0 1 1 12
65 75 0 0 0 1 4 13
66 76 0 0 0 1 2 14
65 73 0 0 0 1 5 15
65 73 0 0 0 1 3 16
64 76 0 0 0 1 4 17
63 76 0 0 0 1 8 18
65 73 0 0 0 1 4 19
65 76 0 0 0 1 7 20
