66 73 0 0 0 1 2 1
66 74 0 0 0 1 2 2
66 74 0 0 0 1 4 3
65 76 0 0 0 1 1 4
65 73 0 0 0 1 5 5
63 75 0 0 0 1 2 6
66 73 0 0 0 1 4 7
65 75 0 0 0 1 1 8
66 76 0 0 0 1 2 9
64 74 0 0 0 1 3 10
65 73 0 0 0 1 1 11
65 74 0 0 0 1 5 12
66 75 0 0 0 1 3 13
63 74 0 0 0 1 7 14
64 75 0 0 0 1 4 15
65 73 0 0 0 1 3 16
63 74 0 0 0 1 6 17
65 75 0 0 0 1 5 18
65 76 0 0 0 1 3 19
63 74 0 0 0 1 1 20
