65 74 0 0 0 1 2 1
65 73 0 0 0 1 4 2
66 74 0 0 0 1 6 3
65 75 0 0 0 1 4 4
63 76 0 0 0 1 2 5
63 76 0 0 0 1 5 6
66 73 0 0 0 1 2 7
63 73 0 0 0 1 1 8
65 75 0 0 0 1 3 9
64 75 0 0 0 1 2 10
65 76 0 0 0 1 3 11
63 75 0 0 0 1 1 12
63 74 0 0 0 1 7 13
66 74 0 0 0 1 4 14
65 74 0 0 0 1 1 15
66 76 0 0 0 1 4 16
64 73 0 0 0 1 3 17
64 74 0 0 0 1 5 18
66 74 0 0 0 1 3 19
63 76 0 0 0 1 1 20
