65 75 0 0 0 1 3 1
63 74 0 0 0 1 1 2
64 74 0 0 0 1 2 3
65 73 0 0 0 1 6 4
63 76 0 0 0 1 2 5
65 76 0 0 0 1 3 6
64 73 0 0 0 1 4 7
65 74 0 0 0 1 3 8
63 73 0 0 0 1 1 9
65 73 0 0 0 1 8 10
64 75 0 0 0 1 1 11
65 76 0 0 0 1 1 12
64 75 0 0 0 1 6 13
65 73 0 0 0 1 2 14
63 73 0 0 0 1 7 15
65 73 0 0 0 1 3 16
65 75 0 0 0 1 4 17
65 75 0 0 0 1 5 18
64 73 0 0 0 1 5 19
63 75 0 0 0 1 2 20
