63 76 0 0 0 1 7 1
66 74 0 0 0 1 4 2
66 76 0 0 0 1 5 3
64 76 0 0 0 1 8 4
64 74 0 0 0 1 5 5
64 76 0 0 0 1 4 6
65 74 0 0 0 1 1 7
64 74 0 0 0 1 6 8
66 73 0 0 0 1 1 9
66 75 0 0 0 1 2 10
64 75 0 0 0 1 1 11
66 76 0 0 0 1 1 12
63 73 0 0 0 1 3 13
66 74 0 0 0 1 3 14
63 73 0 0 0 1 2 15
64 76 0 0 0 1 2 16
65 76 0 0 0 1 3 17
66 73 0 0 0 1 4 18
64 76 0 0 0 1 6 19
63 74 0 0 0 1 2 20
