63 76 0 0 0 1 6 1
64 76 0 0 0 1 4 2
63 73 0 0 0 1 3 3
66 76 0 0 0 1 1 4
66 75 0 0 0 1 2 5
65 73 0 0 0 1 1 6
66 76 0 0 0 1 2 7
65 74 0 0 0 1 6 8
65 76 0 0 0 1 3 9
65 75 0 0 0 1 3 10
64 74 0 0 0 1 4 11
65 74 0 0 0 1 2 12
65 75 0 0 0 1 4 13
66 74 0 0 0 1 5 14
63 73 0 0 0 1 2 15
64 76 0 0 0 1 5 16
64 74 0 0 0 1 1 17
64 74 0 0 0 1 3 18
63 73 0 0 0 1 4 19
65 75 0 0 0 1 1 20
