65 75 0 0 0 1 6 1
64 76 0 0 0 1 4 2
65 76 0 0 0 1 1 3
63 76 0 0 0 1 2 4
66 76 0 0 0 1 5 5
66 75 0 0 0 1 1 6
65 75 0 0 0 1 2 7
65 74 0 0 0 1 1 8
66 75 0 0 0 1 4 9
63 73 0 0 0 1 3 10
66 75 0 0 0 1 3 11
64 74 0 0 0 1 2 12
66 76 0 0 0 1 3 13
63 75 0 0 0 1 5 14
63 75 0 0 0 1 8 15
64 74 0 0 0 1 3 16
66 73 0 0 0 1 2 17
66 75 0 0 0 1 9 18
65 73 0 0 0 1 1 19
65 75 0 0 0 1 7 20
