63 73 0 0 0 1 1 1
66 73 0 0 0 1 4 2
66 74 0 0 0 1 1 3
63 74 0 0 0 1 3 4
65 73 0 0 0 1 6 5
64 74 0 0 0 1 6 6
66 75 0 0 0 1 4 7
66 73 0 0 0 1 3 8
65 76 0 0 0 1 1 9
64 75 0 0 0 1 2 10
63 75 0 0 0 1 5 11
65 74 0 0 0 1 7 12
65 73 0 0 0 1 2 13
63 73 0 0 0 1 7 14
63 73 0 0 0 1 5 15
64 75 0 0 0 1 1 16
66 74 0 0 0 1 4 17
66 74 0 0 0 1 5 18
66 75 0 0 0 1 3 19
66 74 0 0 0 1 2 20
