65 73 0 0 0 1 1 1
66 76 0 0 0 1 4 2
64 74 0 0 0 1 5 3
63 73 0 0 0 1 4 4
63 75 0 0 0 1 2 5
64 74 0 0 0 1 2 6
63 76 0 0 0 1 3 7
63 74 0 0 0 1 3 8
64 74 0 0 0 1 1 9
66 75 0 0 0 1 1 10
66 76 0 0 0 1 1 11
65 73 0 0 0 1 3 12
63 75 0 0 0 1 4 13
65 73 0 0 0 1 2 14
66 74 0 0 0 1 4 15
66 73 0 0 0 1 5 16
63 76 0 0 0 1 5 17
66 76 0 0 0 1 6 18
64 75 0 0 0 1 3 19
65 76 0 0 0 1 2 20
