66 74 0 0 0 1 1 1
64 74 0 0 0 1 2 2
66 73 0 0 0 1 4 3
63 73 0 0 0 1 3 4
64 76 0 0 0 1 5 5
65 73 0 0 0 1 1 6
64 76 0 0 0 1 2 7
66 74 0 0 0 1 3 8
64 76 0 0 0 1 6 9
63 74 0 0 0 1 5 10
64 76 0 0 0 1 1 11
63 76 0 0 0 1 7 12
64 74 0 0 0 1 4 13
66 75 0 0 0 1 1 14
64 76 0 0 0 1 3 15
63 75 0 0 0 1 3 16
63 75 0 0 0 1 2 17
66 73 0 0 0 1 2 18
63 76 0 0 0 1 4 19
63 73 0 0 0 1 5 20
