63 73 0 0 0 1 9 1
65 76 0 0 0 1 1 2
65 73 0 0 0 1 5 3
64 76 0 0 0 1 2 4
63 73 0 0 0 1 2 5
66 75 0 0 0 1 2 6
65 75 0 0 0 1 5 7
65 75 0 0 0 1 3 8
63 73 0 0 0 1 3 9
66 73 0 0 0 1 4 10
66 74 0 0 0 1 2 11
63 73 0 0 0 1 8 12
65 74 0 0 0 1 1 13
64 75 0 0 0 1 1 14
65 76 0 0 0 1 3 15
63 73 0 0 0 1 6 16
64 75 0 0 0 1 4 17
66 73 0 0 0 1 1 18
66 73 0 0 0 1 7 19
66 73 0 0 0 1 10 20
