63 76 0 0 0 1 1 1
64 74 0 0 0 1 1 2
66 73 0 0 0 1 4 3
63 73 0 0 0 1 7 4
64 73 0 0 0 1 3 5
66 73 0 0 0 1 2 6
63 75 0 0 0 1 3 7
66 75 0 0 0 1 2 8
65 76 0 0 0 1 2 9
66 73 0 0 0 1 6 10
64 73 0 0 0 1 1 11
64 76 0 0 0 1 4 12
64 73 0 0 0 1 8 13
66 74 0 0 0 1 2 14
63 73 0 0 0 1 5 15
64 75 0 0 0 1 1 16
65 76 0 0 0 1 3 17
64 74 0 0 0 1 4 18
65 74 0 0 0 1 3 19
66 75 0 0 0 1 4 20
