65         75             0          2          3          1          6          1
64         73             0          2          3          1          2          2
63         74             0          2          3          1          4          3
65         74             0          2          3          1          7          4
65         76             0          2          3          1          3          5
64         74             0          2          3          1          6          6
66         74             0          2          3          1          1          7
65         76             0          2          3          1          2          8
64         75             0          2          3          1          2          9
64         75             0          2          3          1          1         10
64         73             0          2          3          1          1         11
65         76             0          2          3          1          1         12
64         75             0          2          3          1          7         13
63         75             0          2          3          1          4         14
64         74             0          2          3          1          2         15
65         74             0          2          3          1          5         16
63         74             0          2          3          1          3         17
63         75             0          2          3          1          5         18
65         76             0          2          3          1          4         19
65         75             0          2          3          1          3         20