64 73 0 0 0 1 6 1
65 76 0 0 0 1 6 2
64 76 0 0 0 1 4 3
65 73 0 0 0 1 5 4
63 76 0 0 0 1 3 5
64 74 0 0 0 1 5 6
65 74 0 0 0 1 6 7
64 73 0 0 0 1 1 8
63 73 0 0 0 1 2 9
65 76 0 0 0 1 1 10
65 74 0 0 0 1 4 11
63 74 0 0 0 1 1 12
63 76 0 0 0 1 2 13
66 73 0 0 0 1 3 14
66 73 0 0 0 1 4 15
64 76 0 0 0 1 7 16
63 74 0 0 0 1 2 17
65 74 0 0 0 1 3 18
63 75 0 0 0 1 1 19
65 76 0 0 0 1 5 20
