65 74 0 0 0 1 4 1
65 73 0 0 0 1 1 2
63 75 0 0 0 1 1 3
64 74 0 0 0 1 2 4
66 76 0 0 0 1 4 5
63 75 0 0 0 1 4 6
63 76 0 0 0 1 3 7
66 75 0 0 0 1 5 8
65 75 0 0 0 1 2 9
66 74 0 0 0 1 1 10
63 76 0 0 0 1 1 11
63 74 0 0 0 1 7 12
66 74 0 0 0 1 6 13
65 73 0 0 0 1 3 14
63 74 0 0 0 1 3 15
65 75 0 0 0 1 3 16
65 73 0 0 0 1 2 17
66 74 0 0 0 1 5 18
65 75 0 0 0 1 6 19
64 76 0 0 0 1 2 20
