65 73 0 0 0 1 4 1
64 76 0 0 0 1 3 2
66 74 0 0 0 1 3 3
65 76 0 0 0 1 1 4
64 75 0 0 0 1 2 5
63 76 0 0 0 1 4 6
66 74 0 0 0 1 7 7
65 73 0 0 0 1 5 8
63 74 0 0 0 1 2 9
65 74 0 0 0 1 5 10
66 75 0 0 0 1 1 11
66 74 0 0 0 1 4 12
63 74 0 0 0 1 6 13
64 73 0 0 0 1 2 14
63 73 0 0 0 1 3 15
66 75 0 0 0 1 4 16
66 76 0 0 0 1 2 17
63 75 0 0 0 1 3 18
64 73 0 0 0 1 1 19
66 74 0 0 0 1 1 20
